NO ./textures/brick_north.xpm
SO ./textures/brick_south.xpm
WE ./textures/brick_west.xpm
EA ./textures/brick_east.xpm

F 128,64,32
C 135,206,235

1111111111111
1000000000001
1000001000001
1000000000001
1000N00000001
1000000000001
1111111111111
