NO ./assets/wall_n.xpm
SO ./assets/wall_s.xpm
WE ./assets/wall_w.xpm
EA ./assets/wall_e.xpm

F 50,205,50
C 70,130,180

111111111111111111111111111111111111
100000000000000000000000000000000001
100000000000000000000000000000000001
100000000000000111110000000000000001
100000000000000100010000000000000001
100000000000000100010000000000000001
100000000000000111110000000000000001
100000000000000000000000000000000001
100000000000000000000000000000000001
100000000000000000W00000000000000001
111111111111111111111111111111111111