NO ./textures/north.xpm
SO ./textures/south.xpm
WE ./textures/west.xpm
./textures/east.xpm

F 220,100,0
C 225,30,0

1111111
1000000
100D001
1000001
1111111
