NO ./textures/north.xpm
SO ./textures/south.xpm
WE ./textures/west.xpm
EA ./textures/east.xpm

F 300,100,0
C 225,30,500

1111111
1000001
100S001
1000001
1111111