NO assets/textures/Brickwall_Texture.png
SO assets/textures/Brickwall3_Texture.png
WE assets/textures/Brickwall4_Texture.png
EA assets/textures/Stonewall_Texture.png

F 220,100,50
C 225,225,225

111111
100001
100E01
100001
111111
